{
    "block_ids": {
        "0": {
            "name": "air",
            "type": "gas"
        },
        "1": {
            "name": "dirt",
            "type": "solid"
        },
        "2": {
            "name": "grass",
            "type": "solid"
        },
        "3": {
            "name": "stone",
            "type": "solid"
        },
        "4": {
            "name": "stone_brick",
            "type": "solid"
        },
        "5": {
            "name": "water",
            "type": "liquid"
        },
        "6": {
            "name": "guard",
            "type": "gas"
        },
        "7": {
            "name": "boss",
            "type": "gas"
        },
        "8": {
            "name": "portal",
            "type": "gas"
        },
        "9": {
            "name": "player",
            "type": "gas"
        }
    },
    "level_buffs": [null, "strength", "health", "speed", null],
    "level_maps": [
        [
            [0, 0, 0, 0, 0, 0, 0, 0, 0, 0, 0, 0, 0, 0, 0, 0],
            [0, 0, 0, 0, 0, 0, 0, 0, 0, 0, 0, 0, 0, 0, 0, 0],
            [0, 0, 0, 0, 0, 0, 0, 0, 0, 0, 0, 0, 0, 0, 0, 0],
            [0, 0, 0, 0, 0, 0, 0, 0, 0, 0, 0, 0, 0, 0, 0, 0],
            [0, 9, 0, 0, 0, 0, 0, 0, 0, 0, 0, 0, 8, 0, 0, 0],
            [0, 0, 0, 0, 0, 0, 6, 0, 0, 0, 0, 0, 0, 3, 0, 0],
            [0, 0, 3, 0, 6, 3, 3, 6, 0, 0, 0, 0, 3, 3, 3, 0],
            [2, 2, 2, 2, 2, 2, 2, 2, 5, 5, 5, 2, 2, 2, 2, 2],
            [1, 1, 1, 1, 1, 1, 1, 1, 1, 1, 1, 1, 1, 1, 1, 1],
            [1, 1, 1, 1, 1, 1, 1, 1, 1, 1, 1, 1, 1, 1, 1, 1]
        ],
        [
            [4, 4, 4, 4, 4, 4, 4, 4, 4, 4, 4, 4, 4, 4, 4, 4],
            [4, 4, 4, 4, 4, 4, 4, 4, 4, 4, 4, 4, 4, 4, 4, 4],
            [4, 4, 0, 0, 0, 0, 0, 0, 0, 0, 0, 0, 0, 0, 4, 4],
            [4, 4, 0, 0, 0, 0, 0, 0, 0, 0, 0, 0, 0, 0, 4, 4],
            [4, 4, 0, 0, 0, 0, 0, 0, 0, 0, 0, 0, 0, 0, 4, 4],
            [4, 4, 0, 0, 0, 0, 6, 8, 6, 0, 0, 0, 0, 0, 4, 4],
            [4, 4, 0, 0, 0, 0, 4, 4, 4, 0, 0, 0, 0, 0, 4, 4],
            [4, 4, 9, 0, 0, 0, 0, 0, 0, 0, 6, 6, 0, 0, 4, 4],
            [4, 4, 4, 4, 4, 4, 4, 4, 4, 4, 4, 4, 4, 4, 4, 4],
            [4, 4, 4, 4, 4, 4, 4, 4, 4, 4, 4, 4, 4, 4, 4, 4]
        ],
        [
            [4, 4, 4, 4, 4, 4, 4, 4, 4, 4, 4, 4, 4, 4, 4, 4],
            [4, 4, 4, 4, 4, 4, 4, 4, 4, 4, 4, 4, 4, 4, 4, 4],
            [4, 4, 0, 0, 0, 0, 0, 0, 0, 0, 0, 0, 0, 0, 4, 4],
            [4, 4, 0, 0, 0, 0, 0, 0, 0, 0, 0, 0, 0, 0, 4, 4],
            [4, 4, 0, 0, 0, 0, 0, 0, 0, 0, 0, 0, 0, 0, 4, 4],
            [4, 4, 0, 0, 0, 0, 0, 0, 0, 0, 6, 6, 8, 0, 4, 4],
            [4, 4, 0, 0, 0, 0, 0, 0, 0, 6, 3, 3, 3, 0, 4, 4],
            [4, 4, 9, 0, 0, 0, 0, 0, 0, 3, 3, 3, 3, 3, 4, 4],
            [4, 4, 4, 4, 4, 4, 4, 4, 4, 4, 4, 4, 4, 4, 4, 4],
            [4, 4, 4, 4, 4, 4, 4, 4, 4, 4, 4, 4, 4, 4, 4, 4]
        ],
        [
            [4, 4, 4, 4, 4, 4, 4, 4, 4, 4, 4, 4, 4, 4, 4, 4],
            [4, 4, 4, 4, 4, 4, 4, 4, 4, 4, 4, 4, 4, 4, 4, 4],
            [4, 4, 0, 0, 0, 0, 0, 0, 0, 0, 0, 0, 0, 0, 4, 4],
            [4, 4, 0, 0, 0, 0, 0, 0, 0, 0, 0, 0, 0, 0, 4, 4],
            [4, 4, 0, 0, 0, 0, 0, 0, 0, 0, 0, 0, 0, 8, 4, 4],
            [4, 4, 0, 0, 0, 0, 0, 0, 0, 0, 0, 6, 6, 3, 4, 4],
            [4, 4, 0, 0, 0, 0, 0, 0, 0, 0, 6, 3, 3, 3, 4, 4],
            [4, 4, 9, 0, 0, 0, 0, 0, 0, 6, 3, 3, 3, 3, 4, 4],
            [4, 4, 4, 4, 4, 5, 5, 5, 5, 4, 4, 4, 4, 4, 4, 4],
            [4, 4, 4, 4, 4, 4, 4, 4, 4, 4, 4, 4, 4, 4, 4, 4]
        ],
        [
            [0, 0, 0, 0, 0, 0, 0, 0, 0, 0, 0, 0, 0, 0, 0, 0],
            [0, 0, 0, 0, 0, 0, 0, 0, 0, 0, 0, 0, 0, 0, 0, 0],
            [0, 0, 0, 0, 0, 0, 0, 0, 0, 0, 0, 0, 0, 0, 0, 0],
            [0, 0, 0, 0, 0, 0, 0, 0, 0, 0, 0, 0, 0, 0, 0, 0],
            [0, 0, 0, 0, 0, 0, 0, 0, 0, 0, 0, 0, 0, 0, 0, 0],
            [0, 0, 0, 0, 0, 0, 0, 0, 0, 0, 0, 0, 0, 0, 0, 0],
            [0, 0, 0, 0, 0, 0, 0, 7, 0, 0, 0, 0, 0, 0, 0, 0],
            [9, 0, 0, 0, 0, 0, 0, 0, 0, 6, 6, 0, 0, 0, 8, 0],
            [4, 4, 4, 4, 4, 4, 4, 4, 4, 4, 4, 4, 4, 4, 4, 4],
            [4, 4, 4, 4, 4, 4, 4, 4, 4, 4, 4, 4, 4, 4, 4, 4]
        ]
    ]
}